lblPlay	Play
lblQuit	Quit
lblEnterNickname	Enter nickname
lblEnterPassword	Enter password
lblGameMode	Game mode
lblLevel	Level
lblLogIn	Login
lblModeInfo	ModeInfo
lblName	Name
lblNew	New
lblOK	OK
lblPassword	Password
lblRegister	Register
lblScore	Score
lblScoreboard	Scoreboard
lblGameOver	Game Over
lblGoal	Goal
lblNextElement	Next Element
lblPause Pause
lblPressToStart Press TAB to start
lblYouWin	You win!
lblGoToMainMenu	Go to main menu