lblPlay	Играть
lblQuit	Выйти
lblEnterNickname	Введите имя
lblEnterPassword	Введите пароль
lblGameMode	Режим
lblLevel	Уровень
lblLogIn	Войти
lblModeInfo	О режимах
lblName	Имя
lblNew	Новый
lblOK	OK
lblPassword	Пароль
lblRegister	Регистрация
lblScore	Счет
lblScoreboard	Игроки
lblGameOver	Конец игры
lblGoal	Цель
lblNextElement	Следующий элемент
lblPause	Пауза
lblPressToStart	Нажмите TAB для начала игры
lblYouWin	Вы победили!
lblGoToMainMenu	Главное меню